NO textures/eagle.xpm
SO textures/redbrick.xpm
WE textures/purplestone.xpm
EA textures/greystone.xpm

S textures/barrel.xpm
F 220,100,0
C 225,30,0

        111111111111111111111111 1
        100000000011002000200200 1
        101100000111000000000000 1
        100100000000000000000N00 1
11111111101100000111000000000000 1
10000000001100000111011111111111 1
11110111111111011100000012221
11110111111111011101010010001
11002000110101011100000010001
10000000000000001100000010001
10000000000000001101010000001
1100000111010101111101111000111
11110111 1110101 101111010001
11111111 1111111 111111111111