NO ./textures/eagle.xpm
SO ./textures/redbrick.xpm
WE ./textures/purplestone.xpm
EA ./textures/greystone.xpm

S textures/barrel.xpm
F 220,100,0
C 225,30,0

         1
        111111111111111 111111111
        1000000000110020002002001
        1011000001110000000000011
        1001000000000000000000001
111111111011000001110000000000001
100000000011000001110111111111111
11110111111111011100000012221
11110111111111011101010010001
11002000110101011100000010001
10000000000000000100000010001
10000000000000001101010000N01
1100000111010101 11101111000111
11110111 1110101 101111010001
11111111 1111111 111111111111