NO ./textures/eagle.xpm
SO ./textures/eagle.xpm
WE ./textures/purplestone.xpm
EA ./textures/purplestone.xpm

S textures/barrel.xpm
F 220,100,3
F 220,100,3
C 225,30,200
C 225,30,200

         1
        1111111111111111111111111
        10000000001100200020020011
        1011000001110000000000001
        1001000000000000000000001
111111111011000001110000000000001
100000000011000001110111111111110
11110111111111011100000012221
11110111111111011101010010001
11002000110101011100000010001
10000000000000000100000010001
100000000000N0001101010000001
1100000111010101 11101111000111
11110111 1110101 101111010001
11111111 1111111 111111111111